Nível 1 do Lítio
5
3
5
5
0
5
5
1 1 1 1 0 1
2 0 2 2 0 2
3 2 3 3 0 3
4 3 4 4 0 4
5 0 5 5 0 5
